######
#....#
#ooo.#
#   o#
#  @ #
######
